R   800 600

NO  ./srcs/no_tile.xpm 
SO  ./srcs/so_tile.xpm
WE  ./srcs/we_tile.xpm
EA  ./srcs/ea_tile.xpm
S   ./srcs/guard.xpm
S1  ./srcs/officer.xpm

F   77,60,47
C   13,71,161
                                          111
                                         10001
            11111111111111111111        100S001         11111111111111111111           
        111130000000000000000003111111111100011111111111300000000000000000031111               
    1111000000000000000000000000400000000000000000000004000000000000000000000001111                   
        111130000000000000000003111111111130311111111111300000000000000000031111               
            11111111202111111111          141           11111111202111111111           
                    101                   101                   101
                    101                   101                   101
                    101                   101                   101
                    101                   1031111111111111111111202111   
                    101                   10000000000000000004000000031   
                    101                   1031111111111111111111202111   
                 111202111                101                   101
                13000000031               101                   101
                 111202111                101                   101
                    10311111111111111111112021111111111111111111301                   
                    10000000000000000000000000000000000000000000001                   
                     111111111111111111111101111111111111111111111
                                          101
                                          101
                                          101
                                          101
                                         12021
                                        1000001
                                         11011
                                          101
                                           1